11 10
o o o - x x x x - - T
o * * - x x x x - - M
o * o - x x @ @ - - -
- - - - x x x @ - - W
- - - - x x x x - - -
- - - - x x x x - - -
- - - - - - - - - - -
- - # - - - - - - - -
- - # # - - - - - - -
- - - # # - - - - - -
